[
  {
    "level": {
      "0": "--------------------------------",
      "1": "|              A               |",
      "2": "|                              |",
      "3": "|                              |",
      "4": "|                              |",
      "5": "|                              |",
      "6": "|              *               |",
      "7": "--------------------------------"
    }
  },
  {
    "level": {
      "0": "--------------------------------",
      "1": "|                              |",
      "2": "|        ##############        |",
      "3": "|        #A          *#        |",
      "4": "|        ##############        |",
      "5": "|                              |",
      "6": "|                              |",
      "7": "--------------------------------"
    }
  },
  {
    "level": {
      "0": "--------------------------------",
      "1": "|   ################           |",
      "2": "|   #             *#           |",
      "3": "|   # ##############           |",
      "4": "|   # #                        |",
      "5": "|   #A#                        |",
      "6": "|   ###                        |",
      "7": "--------------------------------"
    }
  },
  {
    "level": {
      "0": "--------------------------------",
      "1": "|                            * |",
      "2": "|####   #####                  |",
      "3": "|   #   #   #                  |",
      "4": "| # #   # #                    |",
      "5": "| # ##### ###                  |",
      "6": "|A#       #                    |",
      "7": "--------------------------------"
    }
  },
  {
    "level": {
      "0": "--------------------------------",
      "1": "|                            * |",
      "2": "|                              |",
      "3": "|                              |",
      "4": "|                              |",
      "5": "|                              |",
      "6": "|A#                            |",
      "7": "--------------------------------"
    }
  }

]